1 9 1 1 1 
1 0 0 10 1
1 10 11 0 1
1 0 0 0 1
1 0 10 0 7
1 0 0 0 1
1 1 1 1 1