1 1 1 1 1 1
1 0 0 0 0 1
1 0 10 0 0 1
1 0 0 0 0 7
1 0 0 0 0 1
1 1 8 1 1 1